NO ./texture/north.xpm
SO ./texture/south.xpm
WE ./texture/west.xpm
EA ./texture/east.xpm

F 85,134,92
C 133,197,233

111111111111111111111111111111111
100000000000000000000000000000E01
111111111111111111111111111111111