NO ./texture/north.xpm
SO ./texture/south.xpm
WE ./texture/west.xpm
EA ./texture/east.xpm

F 85,134,92
C 133,197,233

111111111111111111111111111111111
1S0000000000000000000000000000001
111111111111111111111111111111111