NO ./texture/north.xpm
SO ./texture/south.xpm
WE ./texture/west.xpm
EA ./texture/east.xpm

F 85,134,92
C 133,197,233

11111
10001
10N001
10001
11111