NO ./texture/north.xpm
SO ./texture/south.xpm
WE ./texture/west.xpm
EA ./texture/east.xpm

F 85,134,92
C 133,197,233

11111
1000011
10N00001
1111111